wwwwwwwwwwwwwwwwwwww
w S  wwwww         w
wwwwww   w wTw wwwww
w     ww w   T    Ew
w wwwww wTwwwwTwwwww
w w     w         ww
w w wwwwwTww wwww ww
w w w   w w  T  w ww
w w w w w w www w ww
w T w w w T w w w ww
w wTw w wTw w w w ww
w w w T w w w w w ww
w wTw w w w w w w ww
w w w w w   w w w ww
w w   w   w w w   ww
w wwwww www wwwwwwww
w w      T       w w
w wwwwww    wwwwww w
w                 ew
wwwwwwwwwwwwwwwwwwww