wwwwwwwwwwwwwwwwwwww
w S  w     w     Ew
w ww w www w  wwTwww
w w  w w   w       w
w   www w wwwwww Tww
wT     w   w     w w
w w wwwww wwwww   ww
w      w        w  w
w wwww w wwwww w   w
w w  w w w     w w w
w w  w w w wwwww w w
w w      w       w w
w w wwwwwwww wwwww w
w w     w         w
w w www wwT ww wwwww
w  T                w
w   w wwww wwwwww w
w          w      w w
w wwwwwwwwwwwwwww ww
wwwwwwwwwwwwwwwwwwww